Avarna = aA
Ivarna = iI
Uvarna = uU
Rvarna = fF
Lvarna = xX
Ku = kKgGN
Cu = cCjJY
Retrotu = wWqQR
Tu = tTdDn
Pu = pPbBm
An = aAiIuU
Ak = aAiIuUfFxX
Ik = iIuUfFxX
Uk = uUfFxX
Ekn = eo
Ec = eoEO
Aic = EO
Ac = aAiIuUfFxXeoEO
Ic = iIuUfFxXeoEO
At = aAiIuUfFxXeoEOhyvr
Yan = yvrl
An2 = aAiIuUfFxXeoEOhyvrl
In2 = iIuUfFxXeoEOhyvrl
Yam = yvrlYmNRn
Am = aAiIuUfFxXeoEOhyvrlYmNRn
KNam = NRn
Yacn = yvrlYmNRnJB
Jhash = JBGQD
Bhash = BGQD
Jasch = jbgqd
Basch = bgqd
Jhasch = JBGQDjbgqd
Hasch = hyvrlYmNRnJBGQDjbgqd
Vasch = vrlYmNRnJBGQDjbgqd
Asch = aAiIuUfFxXeoEOhyvrlYmNRnJBGQDjbgqd
Chav = CWTcwt
Khay = KPCWTcwtkp
Jhay = JBGQDjbgqdKPCWTcwtkp
Yay = yvrlYmNRnJBGQDjbgqdKPCWTcwtkp
May = mNRnJBGQDjbgqdKPCWTcwtkp
Cay = cwtkp
Khar = KPCWTcwtkpSzs
Car = cwtkpSzs
Schar = Szs
Jhar = JBGQDjbgqdKPCWTcwtkpSzs
Yar = yvrlYmNRnJBGQDjbgqdKPCWTcwtkpSzs
Schal = Szsh
Jhal = JBGQDjbgqdKPCWTcwtkpSzsh
Hal = yvrlYmNRnJBGQDjbgqdKPCWTcwtkpSzsh
Ral = rlYmNRnJBGQDjbgqdKPCWTcwtkpSzsh
Val = vrlYmNRnJBGQDjbgqdKPCWTcwtkpSzsh
Al = aAiIuUfFxXeoEO
Guna = aeo
Vrddhi = AEO
Sounds = aAiIuUfFxXeoEOHM
Linend =  ,;:.
Rvarna_and_Lvarna = fFxX
Jhal_not_ru = JBGQDjbgqdKPCWTcwtkpSzh
Hasch_and_skta = hyvrlYmNRnJBGQDjbgqda
sktr_and_ru = rs
Khar_and_linend = KPCWTcwtkpSzs ,;:.
Ku_and_Pu_and_Schar = kKgGNpPbBmSzs
Ku_and_Pu = kKgGNpPbBm
Tu_and_skts = tTdDns
Cu_and_sktsch = cCjJYS
Retrotu_sktsh = wWqQRz
Yay_not_Yan = YmNRnJBGQDjbgqdKPCWTcwtkp
sktn_and_sktsh_and_skts = nzs
Hal_and_ru = yvrlYmNRnJBGQDjbgqdKPCWTcwtkpSzshs
Al_and_Linend = aAiIuUfFxXeoEO ,;:.
