a => ikanthya,ihrasva
A => ikanthya,idirgha
i => italavya,ihrasva
I => italavya,idirgha
u => iosthya,ihrasva
U => iosthya,idirgha
f => imurdhanya,ihrasva
F => imurdhanya,idirgha
x => idantya,ihrasva
X => idantya,idirgha
e => italavya,iguna
E => italavya,ivrddhi
o => iosthya,iguna
O => iosthya,ivrddhi
M => ?,?
H => ?,?
k => ikanthya,isparsa1
K => ikanthya,isparsa2
g => ikanthya,isparsa3
G => ikanthya,isparsa4
N => ikanthya,isparsa5
c => italavya,isparsa1
C => italavya,isparsa2
j => italavya,isparsa3
J => italavya,isparsa4
Y => italavya,isparsa5
w => imurdhanya,isparsa1
W => imurdhanya,isparsa2
q => imurdhanya,isparsa3
Q => imurdhanya,isparsa4
R => imurdhanya,isparsa5
t => idantya,isparsa1
T => idantya,isparsa2
d => idantya,isparsa3
D => idantya,isparsa4
n => idantya,isparsa5
p => iosthya,isparsa1
P => iosthya,isparsa2
b => iosthya,isparsa3
B => iosthya,isparsa4
m => iosthya,isparsa5
y => italavya,iantahstha
r => imurdhanya,iantahstha
l => idantya,iantahstha
v => iosthya,iantahstha
S => italavya,iusmana
z => imurdhanya,iusmana
s => idantya,iusmana
h => ikanthya,iantahstha
' => ?,?
~ => ?,?
